стол`ицы	Гр`еции
основн`ой	ч`асти
ч`асти	церем`онии
церем`онии	откр`ытия
откр`ытия	Игр
премьер-мин`истра	Гр`еции
Гр`еции	Константиноса
презид`ента	Междунар`одного
Междунар`одного	Олимп`ийского
Олимп`ийского	комит`ета
Междунар`одного	паралимпийского
паралимпийского	комит`ета
уч`астников	Игр
пост`а	председ`ателя
председ`ателя	Центр`ального
Центр`ального	во`енного
во`енного	сов`ета
сов`ета	ЦВС
ЦВС	КНР
ЦК	комп`артии
комп`артии	Кит`ая
кит`айской	стол`ицы
чл`енов	ЦК
ЦК	КПК
раб`оты	пл`енума
председ`ателя	ЦВС
ЦВС	председ`ателя
председ`ателя	КНР
генер`ального	секретар`я
секретар`я	ЦК
ЦК	КПК
КПК	61-летнего
61-летнего	Ху
Ху	Цзиньтао
перед`ачи	вл`асти
рожд`ения	сов`етской
сов`етской	гв`ардии
дня	рожд`ения
рожд`ения	сов`етской
сов`етской	гв`ардии
нарк`ома	СССР
`этих	див`изий
рак`етной	артилл`ерии
Вел`икой	От`ечественной
От`ечественной	войн`ы
объедин`ений	соедин`ений
соедин`ений	в`оинских
в`оинских	част`ей
корабл`ей	Кр`асной
Кр`асной	`Армии
военносл`ужащих	`этих
`этих	част`ей
беззав`етной	пр`еданности
хр`абрости	ст`ойкости
объединённого	сов`ета
сов`ета	Моск`овского
Моск`овского	комит`ета
комит`ета	ветер`анов
ветер`анов	войн`ы
тыс	гвард`ейцев
призн`ания	м`ужества
м`ужества	геро`изма
геро`изма	ст`ойкости
защ`итников	Р`одины
м`ассовых	коммуник`аций
коммуник`аций	РФ
`Юрия	Лотмана
друг`их	св`язанных
госуд`арственной	подд`ержки
приватиз`ации	госуд`арственных
госуд`арственных	телекомпаний
музык`ального	фестив`аля
футб`ольных	ассоци`аций
с`амых	дл`ительных
дл`ительных	суд`ебных
суд`ебных	тяжб
миров`ого	футб`ола
сво`ей	торг`овой
торг`овой	м`арки
интернетовских	комп`аний
Лат`инской	Ам`ерики
Междунар`одной	федер`ации
несанкционированного	исп`ользования
исп`ользования	м`арки
телеканала	РБК
очаг`а	сейсм`ической
сейсм`ической	акт`ивности
`ядерных	испыт`аний
взр`ыва	происш`едшего
грибов`идной	ф`ормы
южнокорейских	эксп`ертов
`ядерных	испыт`аний
сих	пор
гран`ицы	`этой
`этой	стран`ы
ж`ителей	близлеж`ащих
близлеж`ащих	кит`айских
кит`айских	город`ов
никак`ого	взр`ыва
никак`ого	грибов`идного
грибов`идного	`облака
кит`айской	пров`инции
больш`ого	кол`ичества
кол`ичества	об`ычных
об`ычных	боезар`ядов
сос`еднего	Кит`ая
никак`их	взр`ывов
`ядерного	ор`ужия
об`ычных	вооруж`ений
анон`имного	ист`очника
с	г
`Южной	Кореи
южнокорейского	мин`истра
объедин`ения	Чуна
Чуна	Дон
Дон	Ена
Ена	никак`их
никак`их	`ядерных
`ядерных	испыт`аний
`этого	м`еста
`Южной	Кореи
всег`о	м`ира
америк`анской	экон`омики
замминистра	обор`оны
обор`оны	США
1930-х	год`ов
незав`исимости	Тайваня
кит`айских	власт`ей
м`ощи	КНР
созд`ания	военно-политического
военно-политическо-экономического	бл`ока
возм`ожных	кандид`атов
северокорейского	кр`изиса
Соединённых	Шт`атов
кр`упных	соб`ытия
р`азных	соб`ытия
сво`их	ц`елей
млн	один`оких
один`оких	молод`ых
молод`ых	мужч`ин
террит`ории	Сирии
Геншт`аба	изр`аильской
изр`аильской	`армии
сво`ей	пресс-конфер`енции
никак`их	мер
пр`ежнего	ир`акского
ир`акского	реж`има
междунар`одного	террор`изма
изр`аильского	минюста
тех	пор
изр`аильской	разв`едки
террорист`ической	группир`овки
междунар`одного	террор`изма
иностр`анной	оккуп`ации
руков`одства	стран`ы
полит`ического	уб`ежища
радик`альных	палестинских
палестинских	организ`аций
Джорджа	Б`уша
госуд`арств	подд`ерживающих
экстрем`истских	организ`аций
группир`овок	вед`ущих
шестидневной	войн`ы
Безоп`асности	О`ОН
Голанских	выс`от
войск	об`еих
об`еих	стран
подпис`ания	соглаш`ения
сос`еднего	Ливана
дол`ины	Бекаа
нач`ала	90-х
90-х	гг
судьб`ы	Голанских
Голанских	выс`от
усл`овия	нач`ала
Изр`аиля	офици`ального
офици`ального	заявл`ения
Голанских	выс`от
сир`ийского	руков`одства
руков`одства	предоставл`ения
предоставл`ения	твёрдых
надёжных	гар`антий
гар`антий	безоп`асности
безоп`асности	северо-вост`очных
северо-вост`очных	гран`иц
гран`иц	изр`аильского
изр`аильского	госуд`арства
междунар`одной	м`иссии
конц`а	декабр`я
декабр`я	с
с	г
Австрии	Кан`ады
Кан`ады	Яп`онии
Яп`онии	Непала
Непала	П`ольши
во`енных	наблюд`ателей
наблюд`ателей	О`ОН
миров`ых	комп`аний
подд`ержки	сво`ей
сво`ей	ИТ-инфраструктуры
экон`омии	расх`одов
инд`ийской	аутсорсинговой
аутсорсинговой	комп`ании
миров`ых	комп`аний
сл`едующего	г`ода
сво`их	бизнес-проц`ессов
топ-менеджеров	вед`ущих
вед`ущих	миров`ых
миров`ых	комп`аний
комп`аний	уч`аствовавших
сов`ета	директор`ов
опр`ошенных	менеджеров
привлеч`ения	офшорных
офшорных	комп`аний
ч`астных	лиц
созд`ания	ос`обых
ос`обых	усл`овий
технолог`ического	ц`ентра
ц`ентра	Dubai
своб`одной	з`оны
з`оны	электр`онной
электр`онной	торг`овли
б`анков	двух
двух	м`естных
м`естных	одног`о
одног`о	регион`ального
одног`о	междунар`одного
г-на	Крейна
Карибского	басс`ейна
регламент`ированных	комп`аний
форс-мажорных	обсто`ятельств
обсто`ятельств	ураг`анов
ураг`анов	террорист`ических
террорист`ических	ат`ак
отключ`ений	электр`ичества
чл`енов	экип`ажа
населённого	п`ункта
обсто`ятельств	катастр`офы
круш`ения	вертолёта
нед`авнего	круш`ения
круш`ения	вертолёта
прич`ин	ав`арии
Вн`утренних	войск
войск	МВД
прич`ин	катастр`офы
катастр`офы	вертолёта
аэроп`орта	Гр`озного
населённого	п`ункта
катастр`офы	вертолёта
пр`авил	полётов
знамен`итого	ф`ильма
знамен`итого	ф`ильма
подн`ожия	кол`онны
кол`онны	Нельсона
сов`етского	кинемат`ографа
музык`антов	Дрезденского
Дрезденского	симфон`ического
симфон`ического	орк`естра
стр`унных	инструм`ентов
полуторачасового	ф`ильма
ф`ильма	Серг`ея
Серг`ея	Эйзенштейна
эмоцион`ального	подъёма
`этого	удив`ительного
удив`ительного	веч`ернего
веч`ернего	ш`оу
Трафальгарской	пл`ощади
соврем`енного	иск`усства
сторон`ы	правоохран`ительных
правоохран`ительных	`органов
никак`их	серьёзных
серьёзных	инцид`ентов
Алекс`ея	Суворина
кн`ижного	д`ела
дня	рожд`ения
рожд`ения	Алекс`ея
Алекс`ея	Серг`еевича
Серг`еевича	Суворина
Суворина	изв`естного
изв`естного	р`усского
р`усского	литер`атора
литер`атора	театр`ального
театр`ального	д`еятеля
д`еятеля	просвет`ителя
всег`о	изв`естного
выда`ющегося	р`усского
р`усского	изд`ателя
р`усской	литерат`уры
шир`окой	п`ублики
Баратынского	Г`оголя
Г`оголя	Грибоедова
Грибоедова	Досто`евского
Досто`евского	Толст`ого
Толст`ого	Карамзина
Карамзина	Ч`ехова
с`амых	знач`ительных
знач`ительных	соб`ытий
дня	см`ерти
см`ерти	Алекс`андра
Алекс`андра	Серг`еевича
Серг`еевича	П`ушкина
П`ушкина	10-томного
10-томного	собр`ания
собр`ания	сочин`ений
сочин`ений	вел`икого
вел`икого	по`эта
Дешёвой	библиот`еки
`этой	с`ерии
своег`о	от`ечества
Екатер`ины	Втор`ой
изд`ателя	Суворина
изд`ательской	д`еятельности
литерат`урного	худ`ожественного
худ`ожественного	`общества
ценз`уры	разреш`ения
н`екоторых	пьес
дня	рожд`ения
рожд`ения	Суворина
н`овой	кн`иги
м`еста	происш`ествия
дор`ожного	движ`ения
патр`ульной	маш`ины
офиц`ера	пол`иции
был`ых	сраж`ений
был`ых	сраж`ений
Новгородской	поиск`овой
поиск`овой	экспед`иции
Вел`икой	От`ечественной
От`ечественной	войн`ы
Кр`асной	`Армии
докум`ентов	ор`ужия
новгородского	посёлка
г`орода	Петропавловска
населённого	п`ункта
р`яда	посл`едних
посл`едних	лет
времён	войн`ы
шт`аба	экспед`иции
Новгородской	`области
п`амяти	пог`ибших
